%%%%%%%%%%%%%%%%%%%%%%%%%%%%%%%%%%%%%
% P                                F%
% . %%%%%%%%%%%%%%%%%%%%%%%%%%%%%%% %
%                                .% %
%   %%%%%%%%%%%%%%%%%%%%%%%%%%%%  % %
%                            .    % %
%   %%%%%%%%%%%%%%%%%%%%%%%%%     % %
%   .                             % %
%   % % %%% %%%%%%%%%%%%%%%%% .   % %
%          .                      % %
%   %%% %%% %%%%%%%%%%%%%         % %
%   %%% %%% %%%%%%%%%%%%          % %
%   %%%    .%%%%%%%%%%%           % %
%   %%% %%%%%%%%%%%%%           . % %
%                             .. .% %
%   %%%%%%%%%%%%%%%%%%%%%%%%%%%%% % %
%     %%%%%%%%%%%%%%%%%%%%%%%%%%% % %
%      %%%%%%%%%%%%%%%%%%%%%%%%%% % %
%                                 % %
%                                 % %
%    %%   %%          %%   %%     % %
%    %%   %%          %%   %%     % %
%    %%   %%          %%   %%     % %
%                                 % %
%                                 % %
%   %%     %%                     % %
%   %%%%%%%%%         %%%%%%%%%   % %
%                     %%     %%   % %
%                                 % %
%                                 % %
%                                 % %
%                                 % %
%                                 % %
%                                 % %
%                                 % %
%                                  .%
%%%%%%%%%%%%%%%%%%%%%%%%%%%%%%%%%%%%%
