%%%%%%%%%%%%%%%%%%%%%%%%%%%%%%%%%%%%
%P                                 %
%.%%%%%%%%%%%%%%%%%%% %%% %%%%%%%% %
% %%   %   %      %%% %%%   %%     %
% %% % % % % %%%% %%%%%%%%% %% %%% %
% %% % % % % %    %%     %% %%     %
% %% % % % % % %%%%  %%%    %%%%%% %
% %  % % %   %    %% %%%%%%%%      %
% %% % % %%%%%%%% %%        %% %%% %
% %% %   %%       %%%%%%%%% %%     %
%    %%%%%% %%%%%%%      %% %%%%%% %
%  %%       %       %%%% %% %      %
%    . % %%%% %%%%% %    %% %% %%% %
% %%%.%%..    %F      %%%%% %%     %
%   .     %.%%% %%%%%%%%%%  %%  %% %
%          .                %%%%%% %
%  .     .   %%%%%%%%%%%%%         %
%%%%%%%%%%%%%%%%%%%%%%%%%%%%%%%%%%%%
