%%%%%%%%%%%%%%%%%%%%
%                 P%
%       ...        %
%F      . .        %
%       ...        %
%           .      %
%%%%%%%%%%%%%%%%%%%%
